..........
..........
..XXXX....
......X...
X.....X...
X.....X...
X.........
...XX.....
..........
....XXXX..
