...XXXXX..
..........
..X.....X.
..X.....X.
..X.......
..X.......
.....X....
.....X....
.....X....
.....X....
